#,#,#,#,#,#,#,#,#,#,#,#,#
#,,#,,,,,,#,*,,C,#
#,,#,,,#,#,,,,#,,#
#,,#,,,#,#,#,#,#,#,,#
#,,,,,,,=,X,R,=,,#
#,#,,#,#,#,#,#,#,#,#,,#
#,,,,,,,,,,,,#
#,#,#,#,#,#,#,#,#,#,#,#,#