#,#,#,#,#,#,#,#,#,#,#,#,#
#,C,#,,,,,,#,,,,#
#,,#,,,#,#,,,,#,,#
#,,#,,,#,#,,#,#,#,,#
#,,,,,,,,#,,,,#
#,#,#,#,#,#,#,#,#,,#,,#
#,,,,,,,,,,#,,#
#,#,#,#,#,#,#,#,#,#,#,#,#