#,#,#,#,#
#,#,,#,#
#,,,,#
#,#,,#,#
#,#,#,#,#